                                       .:--================================--:.                         
                              .-====+****++==+*==========**==========**====++****+====-.                
                         :=++++*+*+==-:.      #          :*          *:       .:-=%==+**+++=:           
                     .=+=====-:  .*=          -*         .%          %          :*.    :-=====+=.       
                   .+=.:+-         :*:         *:         %         :*         =+           -+:.=+.     
                  :#  .%             -*.        #         #.        +-        *-              %.  #.    
                  ==   ++              =+       -+        +-        %       :*.             .++   +=    
                   *=   .=+=:           .+=      =  ...::::::::...  =      =+            :=+=.   =*     
                    %*=:    :=====-:.     .:=======---::::::::::---=======:.     .:-====-:    :+*%      
                    :* :++=-.     .:-====*#*===--:::..............:::--==+*#*====-:.     .-=+=: *:      
                     #.    :-=++=-:.            ..:::::--------:::::..            .:-====-.    .#       
                     -+          .:-=========-:::...              ...::--=========-:.          +-       
                      %      .+              ..:::---============---:::..              +.      %        
                      #.      %           -                                -           %      .#        
                      +-      %           %                                %           %      -+        
                      -+      #.          %                                %          .#      +-        
                      -*      #.          #.          .-======-.          .#          .#      *-        
                      :*      *:          #:       .++-        -++.       .#          :*      *:        
                      -+      *:          *:      =+  .========.  +=      :*          :*      +-        
                      ==      #.          *:     +=  *=        =*  =+     :*          .#      ==        
                      *:      #.          *:    .#  #:          :#  #.    :*          .#      :*        
                      #.      %           #.    -+  %            %  +-    .#           %      .#        
                      .*-     %           #.    =+  %            %  +=    .#           %     -*.        
                        :+=: .#           %     =+  %            %  +=     %           #. :=+:          
                           :=+*=:.        %     =+  %            %  +=     %        .:=*+=:             
                                :-=====---#     =+  %            %  +=     #---=====-.                  
                                        .:--====++==#============#==++====--:.