                                    =:::.                                                                               
                                  :-    .:-                               :.                                            
                                 -.        -=.                           .. :               ..      ..                  
                               .:            =+                          :   :            .-......    .:                
                              :               :*:                        :    .          :=.- - ......  :               
                            ..                 .#-                       .    ..        :=-...:.- - - .. .              
                           .                    -*:                       :.. ::        --:.  . .::::..:=-              
                                                 %=                       .  . :        :-  :      .   -=-              
                  -+#%%#+                       .#*-+##::=-                -  . :        ..             -               
    :=--===--: .:%@@: ::*         ..::::-----==*-=++-=+-:                   : . :          ...       ...                
 :=+:      ::-*=.  .-*-.-.     ...        .:---..@+*.                       :  ::           .::-..:.:..                 
 +:    .-##=::..-%=--- .+.            :--:::  :--##:                         : ...         -. :     -  .:               
  #  .#..-+      * .*+-:+      .=+=--*=:.   ==.  *-                          .. .-       .=:=.-. ....   +:.             
  :%:     -%==.=%- :.#@-.--:=+*+.     .  .=#:    #:                           : ....:  .:.  -=      ...=.  :            
    +*:.-*#@. =::=*#-:..:: .+@*=-:::===+--:     -+                             ..::=:..-+.:: :.    ::::=--.:=:....      
      -+%@*@:    .%+     .#@@:  .=%*.           *.                          .: .=--=: ::-.    -     .:........  . :     
        =* %      %-     *:=@%%*+-.            +-                           -:=::--+..      .-:     :: ::.:::.:. .:     
        *% -+. .-**==-:: . @+ .-              +-                                :=-=:       :  -===:=:::   =   .=:-     
         *%-.--::=*::-=. .*+    -:           +:                                  ..       .:  =: --  -:.::. ::::-:-     
          -% ..   .   :  *.      :=        .+.                                            =:.: :.:.:::.:   ::   =.:.    
           -+ .-  :  :..#:         =-     -:                                              +-:: .:    -::-: :: :-.: .    
            =- :  .    -:           :+. ::                                               :-  ==       =-.  ..   :.      
            .#.*:-#-=#:+-             -.                                                  +::=::      :::-:  ..:.       
            :@#=: .:=*#@*                                                                  +:  .:       =.. .:          
            *@=.     -*@@:                                                                  =:  :.       :   -          
            ++===++*#%@@@%                                                                   -:..:       :.. -          
                     :-+%@.                                                                 :....:       :. :-.         
                                                                                                         .....          