                                          ::                              :.                                            
                ..      ..               : ..                            .. :               ..      ..                  
              :.    ......-            .:   :                            :   :            .-......    .:                
             :  ...... : -.=.               :                            :    .          :=.- - ......  :               
            : ...:.- :.:...-=:        :    ..                            .    ..        :=-...:.- - - .. .              
            ==:: :::-... ..:--        :: ..:                              :.. ::        --:.  . .::::..:=-              
            =+-   :      :  -:        : . ..                              .  . :        :-  :      .   -=-              
             :             ..        : .  :                                -  . :        ..             -               
              ...       ...          - . :                                  : . :          ...       ...                
               ..:.:..-:..           -.  :                                  :  ::           .::-..:.:..                 
             :.  -     - .:         :.. -                                    : ...         -. :     -  .:               
           :-*   .... .-.=--.       -. :                                     .. .-       .=:=.-. ....   +:.             
          :  .-...      =:  ::.  :.... .                                      : ....:  .:.  -=      ...=.  :            
    ....:=:.--=:::.    :  ::.+:..:=:: .                                        ..::=:..-+.:: :.    ::::=--.:=:....      
   : .  ........::     :    .-:: :+--= .:                                   .: .=--=: ::-.    -     .:........  . :     
   :. ::.:.:.:: :.     :-.      ..+-::-=:-                                  -:=::--+..      .-:     :: ::.:::.:. .:     
   ::=.  .-   :.:=:===:  :       -=-=.                                          :=-=:       :  -===:=:::   =   .=:-     
  .::-:::. .:::.=  -: :=  :.       ..                                            ..       .:  =: --  -:.::. ::::-:-     
  :..=   ::   :..:..::: :.:=                                                              =:.: :.:.:::.:   ::   =.:.    
  . :.-: ::.:-::-    :. ::-=                                                              +-:: .:    -::-: :: :-.: .    
    .:   .. ..-=       =-  =.                                                            :-  ==       =-.  ..   :.      
     .:..  :-:::      ::=::+                                                              +::=::      :::-:  ..:.       
        :  ..=       :.  :=                                                                +:  .:       =.. .:          
        :   -       :.  -=                                                                  =:  :.       :   -          
        : ...       :..::                                                                    -:..:       :.. -          
       .-: .:       :....-                                                                  :....:       :. :-.         
        ....:                                                                                            .....          