                                    =:::.                                      .:::=                                    
                                  :-    .:-                                  -:.    -:                                  
                                 -.        -=.                            .=-         -                                 
                               .:            =+                          =+            ::                               
                              :               :*:                      .#-               :                              
                            ..                 .#-                    :#:                 ..                            
                           .                    -*:                  :+=                    .                           
                                                 %=                  -%                                                 
                  -+#%%#+                       .#*-+##::=-  -+::##+-*%:                       =#%%#+-                  
    :=--===--: .:%@@: ::*         ..::::-----==*-=++-=+-:      :-+=-*=+-*==-----::::..         *:: .@@%:. .---==--=:    
 :=+:      ::-*=.  .-*-.-.     ...        .:---..@+*.               *+@:.---:.        ....     =.-*-.  .=*-::.     :==: 
 +:    .-##=::..-%=--- .+.            :--:::  :--##:                :*%--:  .::---             +. ----%=..::-##-.    .* 
  #  .#..-+      * .*+-:+      .=+=--*=:.   ==.  *-                  -#   ==    :=*--=+=:      =:-+*: *.     +-..*.  #. 
  :%:     -%==.=%- :.#@-.--:=+*+.     .  .=#:    #:                  :#    :#+.  .     .=*+=:--.-@%.: :@=.==%=     .#:  
    +*:.-*#@. =::=*#-:..:: .+@*=-:::===+--:     -+                    +=     :--+===:::--*@*: .:...-#*=::=  @%*- :**.   
      -+%@*@:    .%+     .#@@:  .=%*.           *.                    .*           .+%=.  .@@#.     =%.    .@#@%+-      
        =* %      %-     *:=@%%*+-.            +-                      :*             -+*#%@+.*     :@      %.++        
        *% -+. .-**==-:: . @+ .-              +-                        -*              :. =@ . ::-==**-. .== %#        
         *%-.--::=*::-=. .*+    -:           +:                          :+           :-    +*: .=-::+=::--.-%#         
          -% ..   .   :  *.      :=        .+.                             +:        =:      .#  :   .   .. @-          
           -+ .-  :  :..#:         =-     -:                                :-.    -=         .#..-  :  :. +=           
            =- :  .    -:           :+. ::                                    ::..+:           .=    .  : :+            
            .#.*:-#-=#:+-             -.                                        .-             :*:*=-*=:*:*:            
            :@#=: .:=*#@*                                                                      +@%*=-. :=#@-            
            *@=.     -*@@:                                                                    .@@#-     .=%*            
            ++===++*#%@@@%                                                                    #@@@%##++===++            
                     :-+%@.                                                                   @%*=:                     