                                    =:::.                                        .                                      
                                  :-    .:-                                      --.                                    
                                 -.        -=.                                    ::.                                   
                               .:            =+                                    ::.     ...                          
                              :               :*:                                   ::.   :...=                         
                            ..                 .#-                                   ::.  -:-:+.                        
                           .                    -*:                                   :--..=--+=-.                      
                                                 %=                      ..  ..:..    .-=-:..-:..+-                     
                  -+#%%#+                       .#*-+##::=-              :===-:.-=+=-   :*  ::   :+                     
    :=--===--: .:%@@: ::*         ..::::-----==*-=++-=+-:               .+=.==.    :=+=  :   :+-=+                      
 :=+:      ::-*=.  .-*-.-.     ...        .:---..@+*.                   . -+- -=     -++..::.::.::                      
 +:    .-##=::..-%=--- .+.            :--:::  :--##:                    :..+-:=*.     .**:::-=****.                     
  #  .#..-+      * .*+-:+      .=+=--*=:.   ==.  *-                    :-:=+:   = ...::=**##+::.:=+   ..                
  :%:     -%==.=%- :.#@-.--:=+*+.     .  .=#:    #:                    :-++-:::.+:..    :**@-...-=+..........           
    +*:.-*#@. =::=*#-:..:: .+@*=-:::===+--:     -+                       ..     =.    .:-++=:--:-*-..  :    ..+*+-:     
      -+%@*@:    .%+     .#@@:  .=%*.           *.                              =::::-:.::::-=%+. -. .-::-.:..-:+===    
        =* %      %-     *:=@%%*+-.            +-                              .:::..   .:=*..:#===...::...  .==:=--:   
        *% -+. .-**==-:: . @+ .-              +-                                +- .     .--.:==   =.  :..   :+-:-==:   
         *%-.--::=*::-=. .*+    -:           +:                             .....-:..   -=+.:.+:   :+:..:.  :+# .====.  
          -% ..   .   :  *.      :=        .+.                             : -=::::.-+-**+*=+:*=----#@+:...:-==. --=--- 
           -+ .-  :  :..#:         =-     -:                              ..=  ..:=%%*-  :-:--:      +%@%*:..  :: :-::. 
            =- :  .    -:           :+. ::                                :=   : ==.     .            :==#+  :.+        
            .#.*:-#-=#:+-             -.                                 : #    ::-                   .:+=:  :-:        
            :@#=: .:=*#@*                                                ..+-    :--.              ..:--    ..=         
            *@=.     -*@@:                                                --+     :.=:+.          ::+=      :.+         
            ++===++*#%@@@%                                                 .        ..-=        .:=+.       :-=.        
                     :-+%@.                                                                     ::-.        ::=         