                                                                               .:::=                                    
                                          ::                                 -:.    -:                                  
                ..      ..               : ..                             .=-         -                                 
              :.    ......-            .:   :                            =+            ::                               
             :  ...... : -.=.               :                          .#-               :                              
            : ...:.- :.:...-=:        :    ..                         :#:                 ..                            
            ==:: :::-... ..:--        :: ..:                         :+=                    .                           
            =+-   :      :  -:        : . ..                         -%                                                 
             :             ..        : .  :                  -+::##+-*%:                       =#%%#+-                  
              ...       ...          - . :                     :-+=-*=+-*==-----::::..         *:: .@@%:. .---==--=:    
               ..:.:..-:..           -.  :                          *+@:.---:.        ....     =.-*-.  .=*-::.     :==: 
             :.  -     - .:         :.. -                           :*%--:  .::---             +. ----%=..::-##-.    .* 
           :-*   .... .-.=--.       -. :                             -#   ==    :=*--=+=:      =:-+*: *.     +-..*.  #. 
          :  .-...      =:  ::.  :.... .                             :#    :#+.  .     .=*+=:--.-@%.: :@=.==%=     .#:  
    ....:=:.--=:::.    :  ::.+:..:=:: .                               +=     :--+===:::--*@*: .:...-#*=::=  @%*- :**.   
   : .  ........::     :    .-:: :+--= .:                             .*           .+%=.  .@@#.     =%.    .@#@%+-      
   :. ::.:.:.:: :.     :-.      ..+-::-=:-                             :*             -+*#%@+.*     :@      %.++        
   ::=.  .-   :.:=:===:  :       -=-=.                                  -*              :. =@ . ::-==**-. .== %#        
  .::-:::. .:::.=  -: :=  :.       ..                                    :+           :-    +*: .=-::+=::--.-%#         
  :..=   ::   :..:..::: :.:=                                               +:        =:      .#  :   .   .. @-          
  . :.-: ::.:-::-    :. ::-=                                                :-.    -=         .#..-  :  :. +=           
    .:   .. ..-=       =-  =.                                                 ::..+:           .=    .  : :+            
     .:..  :-:::      ::=::+                                                    .-             :*:*=-*=:*:*:            
        :  ..=       :.  :=                                                                    +@%*=-. :=#@-            
        :   -       :.  -=                                                                    .@@#-     .=%*            
        : ...       :..::                                                                     #@@@%##++===++            
       .-: .:       :....-                                                                    @%*=:                     
        ....:                                                                                                           