                                                                                 .                                      
                                          ::                                     --.                                    
                ..      ..               : ..                                     ::.                                   
              :.    ......-            .:   :                                      ::.     ...                          
             :  ...... : -.=.               :                                       ::.   :...=                         
            : ...:.- :.:...-=:        :    ..                                        ::.  -:-:+.                        
            ==:: :::-... ..:--        :: ..:                                          :--..=--+=-.                      
            =+-   :      :  -:        : . ..                             ..  ..:..    .-=-:..-:..+-                     
             :             ..        : .  :                              :===-:.-=+=-   :*  ::   :+                     
              ...       ...          - . :                              .+=.==.    :=+=  :   :+-=+                      
               ..:.:..-:..           -.  :                              . -+- -=     -++..::.::.::                      
             :.  -     - .:         :.. -                               :..+-:=*.     .**:::-=****.                     
           :-*   .... .-.=--.       -. :                               :-:=+:   = ...::=**##+::.:=+   ..                
          :  .-...      =:  ::.  :.... .                               :-++-:::.+:..    :**@-...-=+..........           
    ....:=:.--=:::.    :  ::.+:..:=:: .                                  ..     =.    .:-++=:--:-*-..  :    ..+*+-:     
   : .  ........::     :    .-:: :+--= .:                                       =::::-:.::::-=%+. -. .-::-.:..-:+===    
   :. ::.:.:.:: :.     :-.      ..+-::-=:-                                     .:::..   .:=*..:#===...::...  .==:=--:   
   ::=.  .-   :.:=:===:  :       -=-=.                                          +- .     .--.:==   =.  :..   :+-:-==:   
  .::-:::. .:::.=  -: :=  :.       ..                                       .....-:..   -=+.:.+:   :+:..:.  :+# .====.  
  :..=   ::   :..:..::: :.:=                                               : -=::::.-+-**+*=+:*=----#@+:...:-==. --=--- 
  . :.-: ::.:-::-    :. ::-=                                              ..=  ..:=%%*-  :-:--:      +%@%*:..  :: :-::. 
    .:   .. ..-=       =-  =.                                             :=   : ==.     .            :==#+  :.+        
     .:..  :-:::      ::=::+                                             : #    ::-                   .:+=:  :-:        
        :  ..=       :.  :=                                              ..+-    :--.              ..:--    ..=         
        :   -       :.  -=                                                --+     :.=:+.          ::+=      :.+         
        : ...       :..::                                                  .        ..-=        .:=+.       :-=.        
       .-: .:       :....-                                                                      ::-.        ::=         
        ....:                                                                                                           