                                          .                                    .:::=                                    
                                        :-.                                  -:.    -:                                  
                                       :::                                .=-         -                                 
                              ...     .:.                                =+            ::                               
                             = ..-   .:.                               .#-               :                              
                            :=:-::  .::                               :#:                 ..                            
                          :-++:=- :--:                               :+=                    .                           
                         +=..:-.::==-.    ..:.. ...                  -%                                                 
                         *.   -. -+:  .-=+-:..=-+=           -+::##+-*%:                       =#%%#+-                  
                          +=-+   .. .=+-.    :=-:==            :-+=-*=+-*==-----::::..         *:: .@@%:. .---==--=:    
                          :..:::.: :++:     =: +=::                 *+@:.---:.        ....     =.-*-.  .=*-::.     :==: 
                         :*+*+=--.-*+      :+=:== .:                :*%--:  .::---             +. ----%=..::-##-.    .* 
                    ..   *-..:-+##+*-::... +   :*-:-.                -#   ==    :=*--=+=:      =:-+*: *.     +-..*.  #. 
              ..........:*=:...+%**.    ..==.:::=+=-.                :#    :#+.  .     .=*+=:--.-@%.: :@=.==%=     .#:  
        .:=+*+..   ..  ..=+--=::*==-:.    --    ..                    +=     :--+===:::--*@*: .:...-#*=::=  @%*- :**.   
       .==+=:-..:.-::-. .- :*#=-- -..:-::.--                          .*           .+%=.  .@@#.     =%.    .@#@%+-      
       ---=.*:.  : :.:..-===#..:*-:    ..::-                           :*             -+*#%@+.*     :@      %.++        
       --=-.*-:  . :.  ::   +=.:=:      . +-                            -*              :. =@ . ::-==**-. .== %#        
      :==== :%-:   : .-+.   -=.:=-=:   ..:-.....                         :+           :-    +*: .=-::+=::--.-%#         
    .---=-- :+-::...-*@+----++-=++**=-+:.:::-=: :                          +:        =:      .#  :   .   .. @-          
    ..:-:. -. ...-#%@%=      :--:-: .=#@#-:.  .-:                           :-.    -=         .#..-  :  :. +=           
           .+:. .*#-=.           ..     .+: :  :::                            ::..+:           .=    .  : :+            
            =::  :+=:.                   =..   :=..                             .-             :*:*=-*=:*:*:            
             =:    .--:..              :=:.    -=:                                             +@%*=-. :=#@-            
             * :     .+=::          -=-::.     +::                                            .@@#-     .=%*            
            -=::       .#::         =:..                                                      #@@@%##++===++            
            .=:.        :-:.                                                                  @%*=:                     
                                                                                                                        