                                          .                                                                             
                                        :-.                               :.                                            
                                       :::                               .. :               ..      ..                  
                              ...     .:.                                :   :            .-......    .:                
                             = ..-   .:.                                 :    .          :=.- - ......  :               
                            :=:-::  .::                                  .    ..        :=-...:.- - - .. .              
                          :-++:=- :--:                                    :.. ::        --:.  . .::::..:=-              
                         +=..:-.::==-.    ..:.. ...                       .  . :        :-  :      .   -=-              
                         *.   -. -+:  .-=+-:..=-+=                         -  . :        ..             -               
                          +=-+   .. .=+-.    :=-:==                         : . :          ...       ...                
                          :..:::.: :++:     =: +=::                         :  ::           .::-..:.:..                 
                         :*+*+=--.-*+      :+=:== .:                         : ...         -. :     -  .:               
                    ..   *-..:-+##+*-::... +   :*-:-.                        .. .-       .=:=.-. ....   +:.             
              ..........:*=:...+%**.    ..==.:::=+=-.                         : ....:  .:.  -=      ...=.  :            
        .:=+*+..   ..  ..=+--=::*==-:.    --    ..                             ..::=:..-+.:: :.    ::::=--.:=:....      
       .==+=:-..:.-::-. .- :*#=-- -..:-::.--                                .: .=--=: ::-.    -     .:........  . :     
       ---=.*:.  : :.:..-===#..:*-:    ..::-                                -:=::--+..      .-:     :: ::.:::.:. .:     
       --=-.*-:  . :.  ::   +=.:=:      . +-                                    :=-=:       :  -===:=:::   =   .=:-     
      :==== :%-:   : .-+.   -=.:=-=:   ..:-.....                                 ..       .:  =: --  -:.::. ::::-:-     
    .---=-- :+-::...-*@+----++-=++**=-+:.:::-=: :                                         =:.: :.:.:::.:   ::   =.:.    
    ..:-:. -. ...-#%@%=      :--:-: .=#@#-:.  .-:                                         +-:: .:    -::-: :: :-.: .    
           .+:. .*#-=.           ..     .+: :  :::                                       :-  ==       =-.  ..   :.      
            =::  :+=:.                   =..   :=..                                       +::=::      :::-:  ..:.       
             =:    .--:..              :=:.    -=:                                         +:  .:       =.. .:          
             * :     .+=::          -=-::.     +::                                          =:  :.       :   -          
            -=::       .#::         =:..                                                     -:..:       :.. -          
            .=:.        :-:.                                                                :....:       :. :-.         
                                                                                                         .....          