                                          .                                      .                                      
                                        :-.                                      --.                                    
                                       :::                                        ::.                                   
                              ...     .:.                                          ::.     ...                          
                             = ..-   .:.                                            ::.   :...=                         
                            :=:-::  .::                                              ::.  -:-:+.                        
                          :-++:=- :--:                                                :--..=--+=-.                      
                         +=..:-.::==-.    ..:.. ...                      ..  ..:..    .-=-:..-:..+-                     
                         *.   -. -+:  .-=+-:..=-+=                       :===-:.-=+=-   :*  ::   :+                     
                          +=-+   .. .=+-.    :=-:==                     .+=.==.    :=+=  :   :+-=+                      
                          :..:::.: :++:     =: +=::                     . -+- -=     -++..::.::.::                      
                         :*+*+=--.-*+      :+=:== .:                    :..+-:=*.     .**:::-=****.                     
                    ..   *-..:-+##+*-::... +   :*-:-.                  :-:=+:   = ...::=**##+::.:=+   ..                
              ..........:*=:...+%**.    ..==.:::=+=-.                  :-++-:::.+:..    :**@-...-=+..........           
        .:=+*+..   ..  ..=+--=::*==-:.    --    ..                       ..     =.    .:-++=:--:-*-..  :    ..+*+-:     
       .==+=:-..:.-::-. .- :*#=-- -..:-::.--                                    =::::-:.::::-=%+. -. .-::-.:..-:+===    
       ---=.*:.  : :.:..-===#..:*-:    ..::-                                   .:::..   .:=*..:#===...::...  .==:=--:   
       --=-.*-:  . :.  ::   +=.:=:      . +-                                    +- .     .--.:==   =.  :..   :+-:-==:   
      :==== :%-:   : .-+.   -=.:=-=:   ..:-.....                            .....-:..   -=+.:.+:   :+:..:.  :+# .====.  
    .---=-- :+-::...-*@+----++-=++**=-+:.:::-=: :                          : -=::::.-+-**+*=+:*=----#@+:...:-==. --=--- 
    ..:-:. -. ...-#%@%=      :--:-: .=#@#-:.  .-:                         ..=  ..:=%%*-  :-:--:      +%@%*:..  :: :-::. 
           .+:. .*#-=.           ..     .+: :  :::                        :=   : ==.     .            :==#+  :.+        
            =::  :+=:.                   =..   :=..                      : #    ::-                   .:+=:  :-:        
             =:    .--:..              :=:.    -=:                       ..+-    :--.              ..:--    ..=         
             * :     .+=::          -=-::.     +::                        --+     :.=:+.          ::+=      :.+         
            -=::       .#::         =:..                                   .        ..-=        .:=+.       :-=.        
            .=:.        :-:.                                                                    ::-.        ::=         